Codon	AminoAcid	Letter	Fullname
AAA	Lys	K	Lysine
AAC	Asn	N	Asparagine
AAG	Lys	K	Lysine
AAT	Asn	N	Asparagine
ACA	Thr	T	Threonine
ACC	Thr	T	Threonine
ACG	Thr	T	Threonine
ACT	Thr	T	Threonine
AGA	Stp	*	Stop
AGC	Ser	S	Serine
AGG	Stp	*	Stop
AGT	Ser	S	Serine
ATA	Met	M	Methionine
ATC	Ile	I	Isoleucine
ATG	Met	M	Methionine
ATT	Ile	I	Isoleucine
CAA	Gln	Q	Glutamine
CAC	His	H	Histidine
CAG	Gln	Q	Glutamine
CAT	His	H	Histidine
CCA	Pro	P	Proline
CCC	Pro	P	Proline
CCG	Pro	P	Proline
CCT	Pro	P	Proline
CGA	Arg	R	Arginine
CGC	Arg	R	Arginine
CGG	Arg	R	Arginine
CGT	Arg	R	Arginine
CTA	Leu	L	Leucine
CTC	Leu	L	Leucine
CTG	Leu	L	Leucine
CTT	Leu	L	Leucine
GAA	Glu	E	Glutamic_acid
GAC	Asp	D	Aspartic_acid
GAG	Glu	E	Glutamic_acid
GAT	Asp	D	Aspartic_acid
GCA	Ala	A	Alanine
GCC	Ala	A	Alanine
GCG	Ala	A	Alanine
GCT	Ala	A	Alanine
GGA	Gly	G	Glycine
GGC	Gly	G	Glycine
GGG	Gly	G	Glycine
GGT	Gly	G	Glycine
GTA	Val	V	Valine
GTC	Val	V	Valine
GTG	Val	V	Valine
GTT	Val	V	Valine
TAA	Stp	*	Stop
TAC	Tyr	Y	Tyrosine
TAG	Stp	*	Stop
TAT	Tyr	Y	Tyrosine
TCA	Ser	S	Serine
TCC	Ser	S	Serine
TCG	Ser	S	Serine
TCT	Ser	S	Serine
TGA	Trp	W	Tryptophan
TGC	Cys	C	Cysteine
TGG	Trp	W	Tryptophan
TGT	Cys	C	Cysteine
TTA	Leu	L	Leucine
TTC	Phe	F	Phenylalanine
TTG	Leu	L	Leucine
TTT	Phe	F	Phenylalanine